E E E E E E E E E E E E E E E E E E E E E E E E E E E E E E E E
E A A A A A A A A A A A A A A A A A E 5 A A A A A A A A A A A E
E 0 A A A A A A A A A A 3 A A A A A E A A A A A A A A A A A A E
E E E E E E E E E E E E E E E F F F E A A A A A A A A A A A A E
E F F F F F F F F F F F F F F F F F F A A A A A A A A A A A A E
E F W W F F F F F F F F F F F F F F F A A A A A A A A A A 1 A E
E W W W E E E E E E E E E E E E E E E E E E E E E E E E E E E E
E W E E E E W E W W E W W W W E E A A A A A E E E A A A A A A E
E W E E E E W W W W W W E E W E E A A A E A A E E E A A A E A E
E W W E E E E E E E E E E E W E E W E A E A A E E E A A E E A E
E W W E E E E A A A E E E E W E W W E F E F F E A A A E E E W E
E W W E E E E A A A A A E E W E W W E F F F E E A A E E E E E E
E W E E E E E A A E E W W E W W W W E E F F E W W E E W W W W E
E W W W W E E E E E E E W W W W W W W W F F W W W W W W W W 4 E
E W W E W E E E W W E E E E E E W W W W F F W W W W W W E E E E
E W W E W E E W W W W W W W W W W W W W W W W W W W W E E E E E
E 2 W E W W W W W W W W W W W W W W W W W W W W W W E E E E E E
E E E E E E E E E E E E E E E E E E E E E E E E E E E E E E E E
